##........
#..##.###.
##.##..##.
##.###.##e
##.#######
....#.##..
###.#.##.#
.##......#
....#.####
#####s####
